11111111111111
10010P00000111
10000CC0000111
110C100C000111
11C11E11111111
11111111111111
