11111111111111111
11111111111111111
1P000000000000C11
100000000000000C1
100000000000000C1
100000000000000C1
11111011111111111
11111011111111111
1C000000000000C11
100000000000000C1
100000000000000C1
10000000000E000C1
11111111111111111
11111111111111111
