1111111111111111111111111111111111111111111
1P00000000000000000000000000000000000000011
1111111111111111111111111111111111111111011
1000000000000000000000000000000000000011C11
1010111111111111111111111111111111111001011
1010000000000000000000000000000000000001011
1011111100111111111111111111111111111111011
1011111100111111111111111111111111111111011
10100000000000E0000000000000000000000001011
1010000000000000000000000000000000000001011
1010111111111111001111111111111111111111011
1010000000000000000000000000000000000001011
1010111111111111001111111111111111111111011
1010000000000000000000000000000000000000011
1011111111111111111111111111111111111111011
10100000000000000000000000000000000000C1011
1010111111111111001111111111111111111111011
1010000000000000000000000000000000000001011
1011111111111111111111110111111111111111011
1011111111111111111111110111111111111111011
1000000000000000000000000000000000000000011
1000111111111111001111111111111111111111011
1111111111111111111111111111111111111111111